001 001 001 001 001 001 001 001 001 001 001 001 001 001 001 001 001 001 001 001
001 000 000 000 000 000 000 000 000 000 000 000 000 000 000 000 000 000 000 001
001 000 000 000 000 000 000 000 001 001 001 001 000 000 000 000 000 000 000 001
001 000 000 000 000 000 000 000 001 000 000 000 000 000 000 000 000 000 000 001
001 000 000 000 000 000 000 000 001 000 000 000 000 000 000 000 000 000 000 001
001 000 000 000 000 000 000 000 001 001 001 001 000 000 000 000 000 000 000 001
001 000 000 000 000 000 000 000 000 000 000 001 000 000 000 000 000 000 000 001
001 000 000 000 000 000 000 000 000 000 000 001 000 000 000 000 000 000 000 001
001 000 000 000 000 000 000 000 001 001 001 001 000 000 000 000 000 000 000 001
001 000 000 000 000 000 000 000 000 000 000 000 000 000 000 000 000 000 000 001
001 000 000 000 000 000 000 000 000 000 000 000 000 000 000 000 000 000 000 001
001 000 000 000 000 000 000 000 000 000 000 000 000 000 000 000 000 000 000 001
001 000 000 000 000 000 000 000 000 000 000 000 000 000 000 000 000 000 000 001
001 000 000 000 000 000 000 000 000 000 000 000 000 000 000 000 000 000 000 001
001 001 001 001 001 001 001 001 001 001 001 001 001 001 001 001 001 001 001 001
0 0 0 0 0 0 0 0 0 0 0 0 0 0 0 0 0 0 0 0
0 0 0 0 0 0 0 0 0 0 0 0 0 0 0 0 0 0 0 0
0 0 0 0 0 0 0 0 0 0 0 0 0 0 0 0 0 0 0 0
0 0 0 0 0 0 0 0 0 0 0 0 0 0 0 0 0 0 0 0
0 0 0 0 0 0 0 0 0 0 0 0 0 0 0 0 0 0 0 0
0 0 0 0 0 0 0 0 0 0 0 0 0 0 0 0 0 0 0 0
0 0 0 0 0 0 0 0 0 0 0 0 0 0 0 0 0 0 0 0
0 0 0 0 0 0 0 0 0 0 0 0 0 0 0 0 0 0 0 0
0 0 0 0 0 0 0 0 0 0 0 0 0 0 0 0 0 0 0 0
0 0 0 0 0 0 0 0 0 0 0 0 0 0 0 0 0 0 0 0
0 0 0 0 0 0 0 0 0 0 0 0 0 0 0 0 0 0 0 0
0 0 0 0 0 0 0 0 0 0 0 0 0 0 0 0 0 0 0 0
0 0 0 0 0 0 0 0 0 0 0 0 0 0 0 0 0 0 0 0
0 0 0 0 0 0 0 0 0 0 0 0 0 0 0 0 0 0 0 0
0 0 0 0 0 0 0 0 0 0 0 0 0 0 0 0 0 0 0 0
resources/maps/test.txt n
none
none
none
ENEMY_TEST 0 0