001 001 001 001 001 001 001 001 001 001 001 001 001 001 001 001 001 001 001 001
001 000 000 000 000 000 000 000 000 000 000 000 000 000 000 000 000 000 000 001
001 000 000 000 000 000 000 000 000 000 000 000 000 000 000 000 000 000 000 001
001 000 000 000 000 000 000 000 000 000 000 000 000 000 000 000 000 000 000 001
001 000 000 000 000 000 001 000 000 000 000 000 001 000 000 000 000 000 000 001
001 000 000 000 000 000 001 000 000 000 000 000 001 000 000 000 000 000 000 001
001 000 000 000 000 000 001 000 000 001 000 000 001 000 000 000 000 000 000 001
001 000 000 000 000 000 001 000 000 001 000 000 001 000 000 000 000 000 000 001
001 000 000 000 000 000 001 000 000 001 000 000 001 000 000 000 000 000 000 001
001 000 000 000 000 000 001 001 001 001 001 001 001 000 000 000 000 000 000 001
001 000 000 000 000 000 000 000 000 000 000 000 000 000 000 000 000 000 000 001
001 000 000 000 000 000 000 000 000 000 000 000 000 000 000 000 000 000 000 001
001 000 000 000 000 000 000 000 000 000 000 000 000 000 000 000 000 000 000 001
001 000 000 000 000 000 000 000 000 000 000 000 000 000 000 000 000 000 000 001
001 001 001 001 001 001 001 001 001 001 001 001 001 001 001 001 001 001 001 001
none n
none n
resources/maps/test.txt n
none n