001 001 001 001 001 001 001 001 001 001 001 001 001 001 001 001 001 001 001 001
001 000 000 000 000 000 000 000 000 000 000 000 000 000 000 000 000 000 000 001
001 000 000 000 000 000 000 000 000 000 000 000 000 000 000 000 000 000 000 001
001 000 000 000 000 000 000 000 000 000 000 000 000 000 000 000 000 000 000 001
001 000 000 000 000 000 000 000 000 000 000 000 000 000 000 000 000 000 000 001
001 000 000 000 000 000 000 000 000 000 000 000 000 000 000 000 000 000 000 001
001 000 000 000 000 000 000 000 000 000 000 000 000 000 000 000 000 000 000 001
001 000 000 000 000 000 000 000 000 000 000 000 000 000 000 000 000 000 000 001
001 000 000 000 000 000 000 000 000 000 000 000 000 000 000 000 000 000 000 001
001 000 000 000 000 000 000 000 000 000 000 000 000 000 000 000 000 000 000 001
001 000 000 000 000 000 000 000 000 000 000 000 000 000 000 000 000 000 000 001
001 000 000 000 000 000 000 000 000 000 000 000 000 000 000 000 000 000 000 001
001 000 000 000 000 000 000 000 000 000 000 000 000 000 000 000 000 000 000 001
001 000 000 000 000 000 000 000 000 000 000 000 000 000 000 000 000 000 000 001
001 001 001 001 001 001 001 001 001 001 001 001 001 001 001 001 001 001 001 001
0 0 0 0 0 0 0 0 0 0 0 0 0 0 0 0 0 0 0 0
0 0 0 0 0 0 0 0 0 0 0 0 0 0 0 0 0 0 0 0
0 0 0 0 0 0 0 0 0 0 0 0 0 0 0 0 0 0 0 0
0 0 0 0 0 0 0 0 0 0 0 0 0 0 0 0 0 0 0 0
0 0 0 0 0 0 0 0 0 0 0 0 0 0 0 0 0 0 0 0
0 0 0 0 0 0 0 0 0 0 0 0 0 0 0 0 0 0 0 0
0 0 0 0 0 0 0 0 0 0 0 0 0 0 0 0 0 0 0 0
0 0 0 0 0 0 0 0 0 0 0 0 0 0 0 0 0 0 0 0
0 0 0 0 0 0 0 0 0 0 0 0 0 0 0 0 0 0 0 0
0 0 0 0 0 0 0 0 0 0 0 0 0 0 0 0 0 0 0 0
0 0 0 0 0 0 0 0 0 0 0 0 0 0 0 0 0 0 0 0
0 0 0 0 0 0 0 0 0 0 0 0 0 0 0 0 0 0 0 0
0 0 0 0 0 0 0 0 0 0 0 0 0 0 0 0 0 0 0 0
0 0 0 0 0 0 0 0 0 0 0 0 0 0 0 0 0 0 0 0
0 0 0 0 0 0 0 0 0 0 0 0 0 0 0 0 0 0 0 0
none
none
none
none