002 002 002 002 002 002 002 002 002 002 002 002 002 002 002 002 002 002 002 002
002 001 001 001 001 001 001 001 001 001 001 001 001 001 001 001 001 001 001 002
002 001 001 001 001 001 001 001 001 001 001 001 001 001 001 001 001 001 001 002
002 001 001 001 001 001 001 001 001 001 001 001 001 001 001 001 001 001 001 002
002 001 001 001 001 001 001 001 001 001 001 001 001 001 001 001 001 001 001 002
002 001 001 001 001 001 001 001 001 001 001 001 001 001 001 001 001 001 001 002
002 001 001 001 001 001 001 001 001 001 001 001 001 001 001 001 001 001 001 002
002 001 001 001 001 001 001 001 001 001 001 001 001 001 001 001 001 001 001 002
002 001 001 001 001 001 001 001 001 001 001 001 001 001 001 001 001 001 001 002
002 001 001 001 001 001 001 001 001 001 001 001 001 001 001 001 001 001 001 002
002 001 001 001 001 001 001 001 001 001 001 001 001 001 001 001 001 001 001 002
002 001 001 001 001 001 001 001 001 001 001 001 001 001 001 001 002 002 001 002
002 001 001 001 001 001 001 001 001 001 001 001 001 001 001 001 002 002 001 002
002 001 001 001 001 001 001 001 001 001 001 001 001 001 001 001 001 001 001 002
002 002 002 002 002 002 002 002 002 002 002 002 002 002 002 002 002 002 002 002
0 0 0 0 0 0 0 0 0 0 0 0 0 0 0 0 0 0 0 0
0 0 0 0 0 0 0 0 0 0 0 0 0 0 0 0 0 0 0 0
0 0 0 0 0 0 0 0 0 0 0 0 0 0 0 0 0 0 0 0
0 0 0 0 0 0 0 0 0 0 0 0 0 0 0 0 0 0 0 0
0 0 0 0 0 0 0 0 0 0 0 0 0 0 0 0 0 0 0 0
0 0 0 0 0 0 0 0 0 0 0 0 0 0 0 0 0 0 0 0
0 0 0 0 0 0 0 0 0 0 0 0 0 0 0 0 0 0 0 0
0 0 0 0 0 0 0 0 0 0 0 0 0 0 0 0 0 0 0 0
0 0 0 0 0 0 0 0 0 0 0 0 0 0 0 0 0 0 0 0
0 0 0 0 0 0 0 0 0 0 0 0 0 0 0 0 0 0 0 0
0 0 0 0 0 0 0 0 0 0 0 0 0 0 0 0 0 0 0 0
0 0 0 0 0 0 0 0 0 0 0 0 0 0 0 0 1 1 0 0
0 0 0 0 0 0 0 0 0 0 0 0 0 0 0 0 1 1 0 0
0 0 0 0 0 0 0 0 0 0 0 0 0 0 0 0 0 0 0 0
0 0 0 0 0 0 0 0 0 0 0 0 0 0 0 0 0 0 0 0
resources/maps/north.txt n
resources/maps/south.txt n
resources/maps/east.txt n
resources/maps/west.txt n